sum,id,auth,term,quality,doi
2903,1290,3,2900,sucess-download,"Marques, E. S.; Severance, E. G.; Min, B.; Arsenault, P.; Conlin, S. M.; Timme-Laragy, A. R. Developmental impacts of Nrf2 activation by dimethyl fumarate (DMF) in the developing zebrafish (Danio rerio) embryo. Free radical biology & medicine. 2022. https://doi.org/10.1016/j.freeradbiomed.2022.12.013."
2702,889,2,2700,sucess-download,"Mas-Rosario, J. A.; Medor, J. D.; Jeffway, M. I.; Martínez-Montes, J. M.; Farkas, M. E. Murine macrophage-based iNos reporter reveals polarization and reprogramming in the context of breast cancer. Frontiers in oncology. 2023. https://doi.org/10.3389/fonc.2023.1151384."
2508,577,8,2500,sucess-download,"Xue, Z.; Ren, K.; Wu, R.; Sun, Z.; Zheng, R.; Tian, Q.; Ali, A. A.; Mi, L.; You, M. Targeted RNA condensation in living cells via genetically encodable triplet repeat tags. Nucleic acids research. 2023. https://doi.org/10.1093/nar/gkad621."
2405,39,5,2400,sucess-download,"Liu, M. J.; Yeh, F. J.; Yvon, R.; Simpson, K.; Jordan, S.; Chambers, J.; Wu, H. M.; Cheung, A. Y. Extracellular pectin-RALF phase separation mediates FERONIA global signaling function. Cell. 2024. https://doi.org/10.1016/j.cell.2023.11.038."
2202,357,2,2200,sucess-download,"Berg, I. K.; Currey, M. L.; Gupta, S.; Berrada, Y.; Nguyen, B. V.; Pho, M.; Patteson, A. E.; Schwarz, J. M.; Banigan, E. J.; Stephens, A. D. Transcription inhibition suppresses nuclear blebbing and rupture independently of nuclear rigidity. Journal of cell science. 2023. https://doi.org/10.1242/jcs.261547."
1806,1027,6,1800,sucess-download,"Liu, B.; Jiang, W.; Ye, Y.; Liu, L.; Wei, X.; Zhang, Q.; Xing, B. 2D MoS Small (Weinheim an der Bergstrasse, Germany). 2023. https://doi.org/10.1002/smll.202208063."
1802,214,2,1800,sucess-download,"Liu, L.; Ashraf, M. A.; Morrow, T.; Facette, M. Stomatal closure in maize is mediated by subsidiary cells and the PAN2 receptor. The New phytologist. 2023. https://doi.org/10.1111/nph.19379."
1502,537,2,1500,sucess-download,"Zhu, L.; Shen, Y.; Deng, S.; Wan, Y.; Luo, J.; Su, Y.; You, M.; Fan, C.; Ren, K. Controllable mitochondrial aggregation and fusion by a programmable DNA binder. Chemical science. 2023. https://doi.org/10.1039/d2sc07095b."
1502,103,2,1500,sucess-download,"Park, Y.; Sato, T.; Lee, J. Functional and analytical recapitulation of osteoclast biology on demineralized bone paper. Nature communications. 2023. https://doi.org/10.1038/s41467-023-44000-9."
1402,1421,2,1400,sucess-download,"Scarpa, G. B.; Starrett, J. R.; Li, G. L.; Brooks, C.; Morohashi, Y.; Yazaki-Sugiyama, Y.; Remage-Healey, L. Estrogens rapidly shape synaptic and intrinsic properties to regulate the temporal precision of songbird auditory neurons. Cerebral cortex (New York, N.Y. : 1991). 2022. https://doi.org/10.1093/cercor/bhac280."
1307,279,7,1300,sucess-download,"Makabenta, J. M.; Nabawy, A.; Chattopadhyay, A. N.; Park, J.; Li, C. H.; Goswami, R.; Luther, D. C.; Huang, R.; Hassan, M. A.; Rotello, V. M. Antimicrobial-loaded biodegradable nanoemulsions for efficient clearance of intracellular pathogens in bacterial peritonitis. Biomaterials. 2023. https://doi.org/10.1016/j.biomaterials.2023.122344."
1303,946,3,1300,sucess-download,"Nan, Q.; Liang, H.; Mendoza, J.; Liu, L.; Fulzele, A.; Wright, A.; Bennett, E. J.; Rasmussen, C. G.; Facette, M. R. The OPAQUE1/DISCORDIA2 myosin XI is required for phragmoplast guidance during asymmetric cell division in maize. The Plant cell. 2023. https://doi.org/10.1093/plcell/koad099."
1202,593,2,1200,sucess-download,"do Rosário, C. F.; Zhang, Y.; Stadnicki, J.; Ross, J. L.; Wadsworth, P. Lateral and longitudinal compaction of PRC1 overlap zones drives stabilization of interzonal microtubules. Molecular biology of the cell. 2023. https://doi.org/10.1091/mbc.E23-02-0049."
1110,1115,10,1100,sucess-download,"Jeon, T.; Luther, D. C.; Goswami, R.; Bell, C.; Nagaraj, H.; Cicek, Y. A.; Huang, R.; Mas-Rosario, J. A.; Elia, J. L.; Im, J.; Lee, Y. W.; Liu, Y.; Scaletti, F.; Farkas, M. E.; Mager, J.; Rotello, V. M. Engineered Polymer-siRNA Polyplexes Provide Effective Treatment of Lung Inflammation. ACS nano. 2023. https://doi.org/10.1021/acsnano.2c08690."
1105,230,5,1100,sucess-download,"Tian, Q.; Yang, F.; Jiang, H.; Bhattacharyya, P.; Xie, T.; Ali, A. A.; Sun, Y.; You, M. Imaging and detecting intercellular tensile forces in spheroids and embryoid bodies using lipid-modified DNA probes. Frontiers in cell and developmental biology. 2023. https://doi.org/10.3389/fcell.2023.1220079."
1102,199,2,1100,sucess-download,"Canniff, N. P.; Graham, J. B.; Guay, K. P.; Lubicki, D. A.; Eyles, S. J.; Rauch, J. N.; Hebert, D. N. TTC17 is an endoplasmic reticulum resident TPR-containing adaptor protein. The Journal of biological chemistry. 2023. https://doi.org/10.1016/j.jbc.2023.105450."
1102,1410,2,1100,sucess-download,"Fu, Y.; McClements, D. J.; Luo, S.; Ye, J.; Liu, C. Degradation kinetics of rutin encapsulated in oil-in-water emulsions: impact of particle size. Journal of the science of food and agriculture. 2022. https://doi.org/10.1002/jsfa.12188."
1013,999,13,1000,sucess-download,"Zhang, X.; Liu, Y.; Doungchawee, J.; Castellanos-García, L. J.; Sikora, K. N.; Jeon, T.; Goswami, R.; Fedeli, S.; Gupta, A.; Huang, R.; Hirschbiegel, C. M.; Cao-Milán, R.; Majhi, P. K.; Cicek, Y. A.; Liu, L.; Jerry, D. J.; Vachet, R. W.; Rotello, V. M. Bioorthogonal nanozymes for breast cancer imaging and therapy. Journal of controlled release : official journal of the Controlled Release Society. 2023. https://doi.org/10.1016/j.jconrel.2023.03.032."
1007,430,7,1000,sucess-download,"Makabenta, J. M.; Nabawy, A.; Chattopadhyay, A. N.; Jeon, T.; Park, J.; Lo, P. C.; Nosovitski, S.; Huang, R.; Li, C. H.; Jiang, M.; Rotello, V. M. Antimicrobial polymer-loaded hydrogels for the topical treatment of multidrug-resistant wound biofilm infections. Journal of controlled release : official journal of the Controlled Release Society. 2023. https://doi.org/10.1016/j.jconrel.2023.09.002."
1005,578,5,1000,sucess-download,"Chen, Z.; Chen, W.; Reheman, Z.; Jiang, H.; Wu, J.; Li, X. Genetically encoded RNA-based sensors with Pepper fluorogenic aptamer. Nucleic acids research. 2023. https://doi.org/10.1093/nar/gkad620."
1005,377,5,1000,sucess-download,"Chiu, K.; Berrada, Y.; Eskndir, N.; Song, D.; Fong, C.; Naughton, S.; Chen, T.; Moy, S.; Gyurmey, S.; James, L.; Ezeiruaku, C.; Capistran, C.; Lowey, D.; Diwanji, V.; Peterson, S.; Parakh, H.; Burgess, A. R.; Probert, C.; Zhu, A.; Anderson, B.; Levi, N.; Gerlitz, G.; Packard, M. C.; Dorfman, K. A.; Bahiru, M. S.; Stephens, A. D. CTCF is essential for proper mitotic spindle structure and anaphase segregation. Chromosoma. 2023. https://doi.org/10.1007/s00412-023-00810-w."
1004,587,4,1000,sucess-download,"Velle, K. B.; Garner, R. M.; Beckford, T. K.; Weeda, M.; Liu, C.; Kennard, A. S.; Edwards, M.; Fritz-Laylin, L. K. A conserved pressure-driven mechanism for regulating cytosolic osmolarity. Current biology : CB. 2023. https://doi.org/10.1016/j.cub.2023.06.061."
908,638,8,900,sucess-download,"Luo, C.; Liu, X.; Zhang, Y.; Dai, H.; Ci, H.; Mou, S.; Zhou, M.; Chen, L.; Wang, Z.; Russell, T. P.; Sun, J. Reconfigurable Magnetic Liquid Building Blocks for Constructing Artificial Spinal Column Tissues. Advanced science (Weinheim, Baden-Wurttemberg, Germany). 2023. https://doi.org/10.1002/advs.202300694."
903,489,3,900,sucess-download,"Morin, S. M.; Gregory, K. J.; Medeiros, B.; Terefe, T.; Hoshyar, R.; Alhusseiny, A.; Chen, S.; Schwartz, R. C.; Jerry, D. J.; Vandenberg, L. N.; Schneider, S. S. Benzophenone-3 exposure alters composition of tumor infiltrating immune cells and increases lung seeding of 4T1 breast cancer cells. Advances in cancer biology - metastasis. 2023. https://doi.org/10.1016/j.adcanc.2022.100080."
902,893,2,900,sucess-download,"Tan, Y.; Zhang, Z.; McClements, D. J. Preparation of plant-based meat analogs using emulsion gels: Lipid-filled RuBisCo protein hydrogels. Food research international (Ottawa, Ont.). 2023. https://doi.org/10.1016/j.foodres.2023.112708."
804,1256,4,800,sucess-download,"Wang, C.; Fu, Y.; Cao, Y.; Huang, J.; Lin, H.; Shen, P.; Julian McClements, D.; Han, L.; Zhao, T.; Yan, X.; Li, Q. Enhancement of lycopene bioaccessibility in tomatoes using excipient emulsions: Effect of dark tea polysaccharides. Food research international (Ottawa, Ont.). 2023. https://doi.org/10.1016/j.foodres.2022.112123."
804,154,4,800,sucess-download,"Nandi, D.; Forster Iii, J.; Ramesh, A.; Nguyen, A.; Bharadwaj, H.; Kulkarni, A. Caspase-1 Responsive Nanoreporter for  ACS applied materials & interfaces. 2023. https://doi.org/10.1021/acsami.3c15733."
803,1222,3,800,sucess-download,"Huynh, U.; Wu, P.; Qiu, J.; Prachyathipsakul, T.; Singh, K.; Jerry, D. J.; Gao, J.; Thayumanavan, S. Targeted Drug Delivery Using a Plug-to-Direct Antibody-Nanogel Conjugate. Biomacromolecules. 2023. https://doi.org/10.1021/acs.biomac.2c01269."
720,1191,20,700,sucess-download,"Huang, J.; Yang, L.; Yang, L.; Wu, X.; Cui, X.; Zhang, L.; Hui, J.; Zhao, Y.; Yang, H.; Liu, S.; Xu, Q.; Pang, M.; Guo, X.; Cao, Y.; Chen, Y.; Ren, X.; Lv, J.; Yu, J.; Ding, J.; Xu, G.; Wang, N.; Wei, X.; Lin, Q.; Yuan, Y.; Zhang, X.; Ma, C.; Dai, C.; Wang, P.; Wang, Y.; Cheng, F.; Zeng, W.; Palanivelu, R.; Wu, H. M.; Zhang, X.; Cheung, A. Y.; Duan, Q. Stigma receptors control intraspecies and interspecies barriers in Brassicaceae. Nature. 2023. https://doi.org/10.1038/s41586-022-05640-x."
707,521,7,700,sucess-download,"Nabawy, A.; Gupta, A.; Jiang, M.; Hirschbiegel, C. M.; Fedeli, S.; Chattopadhyay, A. N.; Park, J.; Zhang, X.; Liu, L.; Rotello, V. M. Biodegradable nanoemulsion-based bioorthogonal nanocatalysts for intracellular generation of anticancer therapeutics. Nanoscale. 2023. https://doi.org/10.1039/d3nr01801f."
706,741,6,700,sucess-download,"Luther, D. C.; Goswami, R.; Lee, Y. W.; Jeon, T.; Huang, R.; Elia, J. L.; Nagaraj, H.; Bijlsma, J. J.; Piest, M.; Langereis, M. A.; Rotello, V. M. Non-viral vaccination through cationic guanidium polymer-pDNA polyplex mediated gene transfer. Nanoscale. 2023. https://doi.org/10.1039/d2nr06428f."
704,350,4,700,sucess-download,"Rajagopalan, N. R.; Munawar, T.; Sheehan, M. C.; Fujimori, M.; Vista, W. R.; Wimmer, T.; Gutta, N. B.; Solomon, S. B.; Srimathveeravalli, G. Electrolysis products, reactive oxygen species and ATP loss contribute to cell death following irreversible electroporation with microsecond-long pulsed electric fields. Bioelectrochemistry (Amsterdam, Netherlands). 2023. https://doi.org/10.1016/j.bioelechem.2023.108579."
704,392,4,700,sucess-download,"Debnath, M.; Forster, J.; Ramesh, A.; Kulkarni, A. Protein Corona Formation on Lipid Nanoparticles Negatively Affects the NLRP3 Inflammasome Activation. Bioconjugate chemistry. 2023. https://doi.org/10.1021/acs.bioconjchem.3c00329."
703,163,3,700,sucess-download,"Sadowska, J. M.; Ziminska, M.; Ferreira, C.; Matheson, A.; Balouch, A.; Bogle, J.; Wojda, S.; Redmond, J.; Elkashif, A.; Dunne, N.; McCarthy, H. O.; Donahue, S.; O'Brien, F. J. Development of miR-26a-activated scaffold to promote healing of critical-sized bone defects through angiogenic and osteogenic mechanisms. Biomaterials. 2023. https://doi.org/10.1016/j.biomaterials.2023.122398."
703,978,3,700,sucess-download,"Giaume, F.; Bono, G. A.; Martignago, D.; Miao, Y.; Vicentini, G.; Toriba, T.; Wang, R.; Kong, D.; Cerise, M.; Chirivì, D.; Biancucci, M.; Khahani, B.; Morandini, P.; Tameling, W.; Martinotti, M.; Goretti, D.; Coupland, G.; Kater, M.; Brambilla, V.; Miki, D.; Kyozuka, J.; Fornara, F. Two florigens and a florigen-like protein form a triple regulatory module at the shoot apical meristem to promote reproductive transitions in rice. Nature plants. 2023. https://doi.org/10.1038/s41477-023-01383-3."
702,352,2,700,sucess-download,"Pandey, A.; Cousin, H.; Horr, B.; Alfandari, D. ADAM11 a novel regulator of Wnt and BMP4 signaling in neural crest and cancer. Frontiers in cell and developmental biology. 2023. https://doi.org/10.3389/fcell.2023.1271178."
702,1297,2,700,sucess-download,"Daitch, A. K.; Orsburn, B. C.; Chen, Z.; Alvarez, L.; Eberhard, C. D.; Sundararajan, K.; Zeinert, R.; Kreitler, D. F.; Jakoncic, J.; Chien, P.; Cava, F.; Gabelli, S. B.; Goley, E. D. EstG is a novel esterase required for cell envelope integrity in Caulobacter. Current biology : CB. 2022. https://doi.org/10.1016/j.cub.2022.11.037."
608,551,8,600,sucess-download,"Park, J.; Nabawy, A.; Doungchawee, J.; Mahida, N.; Foster, K.; Jantarat, T.; Jiang, M.; Chattopadhyay, A. N.; Hassan, M. A.; Agrohia, D. K.; Makabenta, J. M.; Vachet, R. W.; Rotello, V. M. Synergistic Treatment of Multidrug-Resistant Bacterial Biofilms Using Silver Nanoclusters Incorporated into Biodegradable Nanoemulsions. ACS applied materials & interfaces. 2023. https://doi.org/10.1021/acsami.3c06242."
605,1248,5,600,sucess-download,"Nandi, D.; Forster, J.; Ramesh, A.; Nguyen, A.; Bharadwaj, H.; Kulkarni, A. Nanoreporter for Real-Time Monitoring of Inflammasome Activity and Targeted Therapy. Advanced science (Weinheim, Baden-Wurttemberg, Germany). 2023. https://doi.org/10.1002/advs.202204900."
604,356,4,600,sucess-download,"Muncke, J.; Andersson, A. M.; Backhaus, T.; Belcher, S. M.; Boucher, J. M.; Carney Almroth, B.; Collins, T. J.; Geueke, B.; Groh, K. J.; Heindel, J. J.; von Hippel, F. A.; Legler, J.; Maffini, M. V.; Martin, O. V.; Peterson Myers, J.; Nadal, A.; Nerin, C.; Soto, A. M.; Trasande, L.; Vandenberg, L. N.; Wagner, M.; Zimmermann, L.; Thomas Zoeller, R.; Scheringer, M. A vision for safer food contact materials: Public health concerns as drivers for improved testing. Environment international. 2023. https://doi.org/10.1016/j.envint.2023.108161."
603,241,3,600,sucess-download,"Hossain, F.; Ucar, D. A.; Monticone, G.; Ran, Y.; Majumder, S.; Larter, K.; Luu, H.; Wyczechowska, D.; Heidari, S.; Xu, K.; Shanthalingam, S.; Matossian, M.; Xi, Y.; Burow, M.; Collins-Burow, B.; Del Valle, L.; Hicks, C.; Zabaleta, J.; Golde, T.; Osborne, B.; Miele, L. Sulindac sulfide as a non-immune suppressive γ-secretase modulator to target triple-negative breast cancer. Frontiers in immunology. 2023. https://doi.org/10.3389/fimmu.2023.1244159."
603,1378,3,600,sucess-download,"Nabi, D.; Bosi, D.; Gupta, N.; Thaker, N.; Fissore, R.; Brayboy, L. M. Multidrug resistance transporter-1 dysfunction perturbs meiosis and Ca2+ homeostasis in oocytes. Reproduction (Cambridge, England). 2022. https://doi.org/10.1530/REP-22-0192."
602,729,2,600,sucess-download,"Ashraf, M. A.; Liu, L.; Facette, M. R. A polarized nuclear position specifies the correct division plane during maize stomatal development. Plant physiology. 2023. https://doi.org/10.1093/plphys/kiad329."
602,894,2,600,sucess-download,"Lara-Rojas, F.; Juárez-Verdayes, M. A.; Wu, H. M.; Cheung, A. Y.; Montiel, J.; Pascual-Morales, E.; Ryken, S. E.; Bezanilla, M.; Cardenas, L. Using Hyper as a molecular probe to visualize hydrogen peroxide in living plant cells: An updated method. Methods in enzymology. 2023. https://doi.org/10.1016/bs.mie.2022.09.012."
514,450,14,500,sucess-download,"Wu, R.; Prachyathipsakul, T.; Zhuang, J.; Liu, H.; Han, Y.; Liu, B.; Gong, S.; Qiu, J.; Wong, S.; Ribbe, A.; Medeiros, J.; Bhagabati, J.; Gao, J.; Wu, P.; Dutta, R.; Herrera, R.; Faraci, S.; Xiao, H.; Thayumanavan, S. Conferring liver selectivity to a thyromimetic using a novel nanoparticle increases therapeutic efficacy in a diet-induced obesity animal model. PNAS nexus. 2023. https://doi.org/10.1093/pnasnexus/pgad252."
512,278,12,500,sucess-download,"Liu, X.; Rao, S.; Chen, W.; Felix, K.; Ni, J.; Sahasrabudhe, A.; Lin, S.; Wang, Q.; Liu, Y.; He, Z.; Xu, J.; Huang, S.; Hong, E.; Yau, T.; Anikeeva, P.; Zhao, X. Fatigue-resistant hydrogel optical fibers enable peripheral nerve optogenetics during locomotion. Nature methods. 2023. https://doi.org/10.1038/s41592-023-02020-9."
506,1063,6,500,sucess-download,"He, J.; Wu, X.; Xie, Y.; Gao, Y.; McClements, D. J.; Zhang, L.; Zou, L.; Liu, W. Capsaicin encapsulated in W/O/W double emulsions fabricated via ethanol-induced pectin gelling: Improvement of bioaccessibility and reduction of irritation. International journal of biological macromolecules. 2023. https://doi.org/10.1016/j.ijbiomac.2023.123899."
506,713,6,500,sucess-download,"Ramesh, A.; Deshpande, N.; Malik, V.; Nguyen, A.; Malhotra, M.; Debnath, M.; Brouillard, A.; Kulkarni, A. Activatable Nanoreporters for Real-Time Tracking of Macrophage Phenotypic States Associated with Disease Progression. Small (Weinheim an der Bergstrasse, Germany). 2023. https://doi.org/10.1002/smll.202300978."
505,892,5,500,sucess-download,"Qiu, Y.; McClements, D. J.; Chen, J.; Li, C.; Liu, C.; Dai, T. Construction of 3D printed meat analogs from plant-based proteins: Improving the printing performance of soy protein- and gluten-based pastes facilitated by rice protein. Food research international (Ottawa, Ont.). 2023. https://doi.org/10.1016/j.foodres.2023.112635."
504,607,4,500,sucess-download,"Xue, R.; Lan, R.; Su, W.; Wang, Z.; Li, X.; Zhao, J.; Ma, C.; Xing, B. Mechanistic Understanding toward the Maternal Transfer of Nanoplastics in  ACS nano. 2023. https://doi.org/10.1021/acsnano.3c01847."
502,1134,2,500,sucess-download,"Horr, B.; Kurtz, R.; Pandey, A.; Hoffstrom, B. G.; Schock, E.; LaBonne, C.; Alfandari, D. Production and characterization of monoclonal antibodies to Xenopus proteins. Development (Cambridge, England). 2023. https://doi.org/10.1242/dev.201309."
502,628,2,500,sucess-download,"Lehman, T. A.; Rosas, M. A.; Brew-Appiah, R. A.; Solanki, S.; York, Z. B.; Dannay, R.; Wu, Y.; Roalson, E. H.; Zheng, P.; Main, D.; Baskin, T. I.; Sanguinet, K. A. BUZZ: an essential gene for postinitiation root hair growth and a mediator of root architecture in Brachypodium distachyon. The New phytologist. 2023. https://doi.org/10.1111/nph.19079."
502,980,2,500,sucess-download,"Wu, P.; Prachyathipsakul, T.; Huynh, U.; Qiu, J.; Jerry, D. J.; Thayumanavan, S. Optimizing Conjugation Chemistry, Antibody Conjugation Site, and Surface Density in Antibody-Nanogel Conjugates (ANCs) for Cell-Specific Drug Delivery. Bioconjugate chemistry. 2023. https://doi.org/10.1021/acs.bioconjchem.3c00034."
409,202,9,400,sucess-download,"Zhao, J.; Lan, R.; Wang, Z.; Su, W.; Song, D.; Xue, R.; Liu, Z.; Liu, X.; Dai, Y.; Yue, T.; Xing, B. Microplastic fragmentation by rotifers in aquatic ecosystems contributes to global nanoplastic pollution. Nature nanotechnology. 2023. https://doi.org/10.1038/s41565-023-01534-9."
407,368,7,400,sucess-download,"Yang, F.; Chen, P.; Jiang, H.; Xie, T.; Shao, Y.; Kim, D. H.; Li, B.; Sun, Y. Directional Cell Migration Guided by a Strain Gradient. Small (Weinheim an der Bergstrasse, Germany). 2023. https://doi.org/10.1002/smll.202302404."
406,1012,6,400,sucess-download,"Jiang, Z.; Tian, J.; Bai, X.; McClements, D. J.; Ma, C.; Liu, X.; Liu, F. Improving probiotic survival using water-in-oil-in-water (W Food chemistry. 2023. https://doi.org/10.1016/j.foodchem.2023.135889."
406,617,6,400,sucess-download,"Luo, X.; Ao, S.; Wu, H.; McClements, D. J.; Fang, L.; Huang, M.; Zhou, Y.; Yin, X.; Xi, M.; Cai, T.; Zhu, K. Hyaluronic Acid Poly(glyceryl) Journal of agricultural and food chemistry. 2023. https://doi.org/10.1021/acs.jafc.3c02322."
406,467,6,400,sucess-download,"Zhang, X.; Ma, D.; Yin, C.; Li, Z.; Hao, J.; Li, Y.; Zhang, S. The biological activity, functionality, and emulsion stability of soybean meal hydrolysate-proanthocyanidin conjugates. Food chemistry. 2023. https://doi.org/10.1016/j.foodchem.2023.137159."
405,57,5,400,sucess-download,"Xue, W.; Lee, D.; Kong, Y.; Kuss, M.; Huang, Y.; Kim, T.; Chung, S.; Dudley, A. T.; Ro, S. H.; Duan, B. A Facile Strategy for the Fabrication of Cell-laden Porous Alginate Hydrogels Based on Two-phase Aqueous Emulsions. Advanced functional materials. 2023. https://doi.org/10.1002/adfm.202214129."
404,1288,4,400,sucess-download,"Wu, X.; Liu, Y.; Wang, W.; Crimmings, K.; Williams, A.; Mager, J.; Cui, W. Early embryonic lethality of mice lacking POLD2. Molecular reproduction and development. 2022. https://doi.org/10.1002/mrd.23663."
403,37,3,400,sucess-download,"Kumar, D.; Singh, R.; Upadhyay, S. K.; Verma, K. K.; Tripathi, R. M.; Liu, H.; Dhankher, O. P.; Tripathi, R. D.; Sahi, S. V.; Seth, C. S. Review on interactions between nanomaterials and phytohormones: Novel perspectives and opportunities for mitigating environmental challenges. Plant science : an international journal of experimental plant biology. 2024. https://doi.org/10.1016/j.plantsci.2023.111964."
403,849,3,400,sucess-download,"Chen, K.; Muthukumar, M. Substantial Slowing of Electrophoretic Translocation of DNA through a Nanopore Using Coherent Multiple Entropic Traps. ACS nano. 2023. https://doi.org/10.1021/acsnano.2c12921."
402,1374,2,400,sucess-download,"Nan, Q.; Char, S. N.; Yang, B.; Bennett, E. J.; Yang, B.; Facette, M. R. Polarly localized WPR proteins interact with PAN receptors and the actin cytoskeleton during maize stomatal development. The Plant cell. 2022. https://doi.org/10.1093/plcell/koac301."
402,723,2,400,sucess-download,"Zhou, J.; Smith, J. A.; Li, M.; Holmes, D. E. Methane production by  mBio. 2023. https://doi.org/10.1128/mbio.00360-23."
402,404,2,400,sucess-download,"Keum, C.; Hirschbiegel, C. M.; Chakraborty, S.; Jin, S.; Jeong, Y.; Rotello, V. M. Biomimetic and bioorthogonal nanozymes for biomedical applications. Nano convergence. 2023. https://doi.org/10.1186/s40580-023-00390-6."
309,596,9,300,shorty-download,"Howerton, E.; Contamin, L.; Mullany, L. C.; Qin, M.; Reich, N. G.; Bents, S.; Borchering, R. K.; Jung, S. M.; Loo, S. L.; Smith, C. P.; Levander, J.; Kerr, J.; Espino, J.; van Panhuis, W. G.; Hochheiser, H.; Galanti, M.; Yamana, T.; Pei, S.; Shaman, J.; Rainwater-Lovett, K.; Kinsey, M.; Tallaksen, K.; Wilson, S.; Shin, L.; Lemaitre, J. C.; Kaminsky, J.; Hulse, J. D.; Lee, E. C.; McKee, C.; Hill, A.; Karlen, D.; Chinazzi, M.; Davis, J. T.; Mu, K.; Xiong, X.; Piontti, A. P.; Vespignani, A.; Rosenstrom, E. T.; Ivy, J. S.; Mayorga, M. E.; Swann, J. L.; España, G.; Cavany, S.; Moore, S.; Perkins, A.; Hladish, T.; Pillai, A.; Toh, K. B.; Longini, I.; Chen, S.; Paul, R.; Janies, D.; Thill, J. C.; Bouchnita, A.; Bi, K.; Lachmann, M.; Fox, S.; Meyers, L. A.; Srivastava, A.; Porebski, P.; Venkatramanan, S.; Adiga, A.; Lewis, B.; Klahn, B.; Outten, J.; Hurt, B.; Chen, J.; Mortveit, H.; Wilson, A.; Marathe, M.; Hoops, S.; Bhattacharya, P.; Machi, D.; Cadwell, B. L.; Healy, J. M.; Slayton, R. B.; Johansson, M. A.; Biggerstaff, M.; Truelove, S.; Runge, M. C.; Shea, K.; Viboud, C.; Lessler, J. Informing pandemic response in the face of uncertainty.  medRxiv : the preprint server for health sciences. 2023. https://doi.org/10.1101/2023.06.28.23291998."
308,1039,8,300,sucess-download,"Li, X.; He, Y.; Zhang, S.; Gu, Q.; McClements, D. J.; Chen, S.; Liu, X.; Liu, F. Lactoferrin-Based Ternary Composite Nanoparticles with Enhanced Dispersibility and Stability for Curcumin Delivery. ACS applied materials & interfaces. 2023. https://doi.org/10.1021/acsami.2c20816."
307,183,7,300,shorty-download,"Jung, S. M.; Loo, S. L.; Howerton, E.; Contamin, L.; Smith, C. P.; Carcelén, E. C.; Yan, K.; Bents, S. J.; Levander, J.; Espino, J.; Lemaitre, J. C.; Sato, K.; McKee, C. D.; Hill, A. L.; Chinazzi, M.; Davis, J. T.; Mu, K.; Vespignani, A.; Rosenstrom, E. T.; Rodriguez-Cartes, S. A.; Ivy, J. S.; Mayorga, M. E.; Swann, J. L.; España, G.; Cavany, S.; Moore, S. M.; Perkins, A.; Chen, S.; Paul, R.; Janies, D.; Thill, J. C.; Srivastava, A.; Al Aawar, M.; Bi, K.; Bandekar, S. R.; Bouchnita, A.; Fox, S. J.; Meyers, L. A.; Porebski, P.; Venkatramanan, S.; Adiga, A.; Hurt, B.; Klahn, B.; Outten, J.; Chen, J.; Mortveit, H.; Wilson, A.; Hoops, S.; Bhattacharya, P.; Machi, D.; Vullikanti, A.; Lewis, B.; Marathe, M.; Hochheiser, H.; Runge, M. C.; Shea, K.; Truelove, S.; Viboud, C.; Lessler, J. Potential impact of annual vaccination with reformulated COVID-19 vaccines: lessons from the U.S. COVID-19 Scenario Modeling Hub. medRxiv : the preprint server for health sciences. 2023. https://doi.org/10.1101/2023.10.26.23297581."
306,1244,6,300,sucess-download,"Li, Q.; Liu, L.; Zhang, J.; Dong, M.; Wang, L.; Julian McClements, D.; Fu, Y.; Han, L.; Shen, P.; Chen, X. Effects of pile fermentation on the physicochemical, functional, and biological properties of tea polysaccharides. Food chemistry. 2023. https://doi.org/10.1016/j.foodchem.2022.135353."
305,816,5,300,sucess-download,"Gu, P.; Luo, X.; Zhou, S.; Wang, D.; Li, Z.; Chai, Y.; Zhang, Y.; Shi, S.; Russell, T. P. Stabilizing Liquids Using Interfacial Supramolecular Assemblies. Angewandte Chemie (International ed. in English). 2023. https://doi.org/10.1002/anie.202303789."
305,588,5,300,sucess-download,"Guo, S.; Guo, Q.; Zhang, Y.; Peng, X.; Ma, C.; McClements, D. J.; Liu, X.; Liu, F. Preparation of enzymatically cross-linked α-lactalbumin nanoparticles and their application for encapsulating lycopene. Food chemistry. 2023. https://doi.org/10.1016/j.foodchem.2023.136394."
305,916,5,300,sucess-download,"Geng, Q.; McClements, D. J.; Wu, Z.; Li, T.; He, X.; Shuai, X.; Liu, C.; Dai, T. Investigation of bovine β-lactoglobulin-procyanidin complexes interactions and its utilization in O/W emulsion. International journal of biological macromolecules. 2023. https://doi.org/10.1016/j.ijbiomac.2023.124457."
304,1179,4,300,sucess-download,"Wang, H.; Zhao, Y.; Yin, S.; Dai, Y.; Zhao, J.; Wang, Z.; Xing, B. Antagonism toxicity of CuO nanoparticles and mild ocean acidification to marine algae. Journal of hazardous materials. 2023. https://doi.org/10.1016/j.jhazmat.2023.130857."
304,1043,4,300,sucess-download,"Kim, J. H.; Lee, D. E.; Park, S. Y.; Clark, J. M.; Lee, S. H. Histological confinement of transglutaminase-mediated nit sheath crosslinking is essential for proper oviposition and egg coating in the human head louse, Pediculus humanus capitis. Parasites & vectors. 2023. https://doi.org/10.1186/s13071-023-05720-5."
304,1204,4,300,sucess-download,"Goswami, R.; Lehot, V.; Çiçek, Y. A.; Nagaraj, H.; Jeon, T.; Nguyen, T.; Fedeli, S.; Rotello, V. M. Direct Cytosolic Delivery of Citraconylated Proteins. Pharmaceutics. 2023. https://doi.org/10.3390/pharmaceutics15010218."
304,901,4,300,sucess-download,"Adler, F. R.; Anderson, A. R.; Bhushan, A.; Bogdan, P.; Bravo-Cordero, J. J.; Brock, A.; Chen, Y.; Cukierman, E.; DelGiorno, K. E.; Denis, G. V.; Ferrall-Fairbanks, M. C.; Gartner, Z. J.; Germain, R. N.; Gordon, D. M.; Hunter, G.; Jolly, M. K.; Karacosta, L. G.; Mythreye, K.; Katira, P.; Kulkarni, R. P.; Kutys, M. L.; Lander, A. D.; Laughney, A. M.; Levine, H.; Lou, E.; Lowenstein, P. R.; Masters, K. S.; Pe'er, D.; Peyton, S. R.; Platt, M. O.; Purvis, J. E.; Quon, G.; Richer, J. K.; Riddle, N. C.; Rodriguez, A.; Snyder, J. C.; Lee Szeto, G.; Tomlin, C. J.; Yanai, I.; Zervantonakis, I. K.; Dueck, H. Modeling collective cell behavior in cancer: Perspectives from an interdisciplinary conversation. Cell systems. 2023. https://doi.org/10.1016/j.cels.2023.03.002."
303,1273,3,300,sucess-download,"Palmer-Young, E. C.; Malfi, R.; Zhou, Y.; Joyce, B.; Whitehead, H.; Van Wyk, J. I.; Baylis, K.; Grubbs, K.; Boncristiani, D. L.; Evans, J. D.; Irwin, R. E.; Adler, L. S. Sunflower-Associated Reductions in Varroa Mite Infestation of Honey Bee Colonies. Journal of economic entomology. 2022. https://doi.org/10.1093/jee/toac196."
302,973,2,300,sucess-download,"Lu, W.; Wei, Z.; Guo, W.; Yan, C.; Ding, Z.; Wang, C.; Huang, G.; Rotello, V. M. Shaping Sulfur Precursors to Low Dimensional (0D, 1D and 2D) Sulfur Nanomaterials: Synthesis, Characterization, Mechanism, Functionalization, and Applications. Small (Weinheim an der Bergstrasse, Germany). 2023. https://doi.org/10.1002/smll.202301095."
212,1382,12,200,sucess-download,"Liu, H.; Huang, J.; Zhang, X.; Liu, G.; Liang, W.; Zhu, G.; Dong, M.; Li, M.; Zhang, J.; Yang, W.; Xiao, W.; Cheung, A. Y.; Tao, L. Z. The RAC/ROP GTPase activator OsRopGEF10 functions in crown root development by regulating cytokinin signaling in rice. The Plant cell. 2022. https://doi.org/10.1093/plcell/koac297."
208,1250,8,200,sucess-download,"Xiong, Z.; Zhang, X.; White, J. C.; Liu, L.; Sun, W.; Zhang, S.; Zeng, J.; Deng, S.; Liu, D.; Zhao, X.; Wu, F.; Zhao, Q.; Xing, B. Transcriptome Analysis Reveals the Growth Promotion Mechanism of Enteropathogenic  ACS nano. 2023. https://doi.org/10.1021/acsnano.2c09964."
206,523,6,200,sucess-download,"Cao, X.; Chen, X.; Liu, Y.; Wang, C.; Yue, L.; Elmer, W. H.; White, J. C.; Wang, Z.; Xing, B. Lanthanum Silicate Nanomaterials Enhance Sheath Blight Resistance in Rice: Mechanisms of Action and Soil Health Evaluation. ACS nano. 2023. https://doi.org/10.1021/acsnano.3c03701."
205,1186,5,200,sucess-download,"Liu, Z.; Lepori, I.; Chordia, M. D.; Dalesandro, B. E.; Guo, T.; Dong, J.; Siegrist, M. S.; Pires, M. M. A Metabolic-Tag-Based Method for Assessing the Permeation of Small Molecules Across the Mycomembrane in Live Mycobacteria. Angewandte Chemie (International ed. in English). 2023. https://doi.org/10.1002/anie.202217777."
205,188,5,200,sucess-download,"Kelly, M. T.; Chen, Z.; Russell, T. P.; Zhao, B. Amphiphilic Heterografted Molecular Bottlebrushes with Tertiary Amine-Containing Side Chains as Efficient and Robust pH-Responsive Emulsifiers. Angewandte Chemie (International ed. in English). 2023. https://doi.org/10.1002/anie.202315424."
205,1098,5,200,sucess-download,"Zhang, Z.; Li, X. M.; Wang, H.; Lin, H.; Xiao, H.; Li, Z. Seafood allergy: Allergen, epitope mapping and immunotherapy strategy. Critical reviews in food science and nutrition. 2023. https://doi.org/10.1080/10408398.2023.2181755."
205,1293,5,200,sucess-download,"Cui, F.; Han, S.; Wang, J.; McClements, D. J.; Liu, X.; Liu, F. Co-delivery of curcumin and epigallocatechin gallate in W/O/W emulsions stabilized by protein fibril-cellulose complexes. Colloids and surfaces. B, Biointerfaces. 2022. https://doi.org/10.1016/j.colsurfb.2022.113072."
205,929,5,200,sucess-download,"Lian, F.; Han, Y.; Zhang, Y.; Li, J.; Sun, B.; Geng, Z.; Wang, Z.; Xing, B. Exposure Order to Photoaging and Humic Acids Significantly Modifies the Aggregation and Transformation of Nanoplastics in Aqueous Solutions. Environmental science & technology. 2023. https://doi.org/10.1021/acs.est.2c09140."
205,1385,5,200,sucess-download,"Ji, Y.; Yue, L.; Cao, X.; Chen, F.; Li, J.; Zhang, J.; Wang, C.; Wang, Z.; Xing, B. Carbon dots promoted soybean photosynthesis and amino acid biosynthesis under drought stress: Reactive oxygen species scavenging and nitrogen metabolism. The Science of the total environment. 2022. https://doi.org/10.1016/j.scitotenv.2022.159125."
204,396,4,200,sucess-download,"Li, G.; McWilliams, M.; Rodrigues, M.; Mearkle, B.; Jaafar, N.; Golla, V.; Yu, H.; Yang, H.; Ayhan, D. H.; Allen, K.; Martínez-Soto, D.; Springer, A.; Ma, L. J. CUR(E)ating a new approach to study fungal effectors and enhance undergraduate education through authentic research. Biochemistry and molecular biology education : a bimonthly publication of the International Union of Biochemistry and Molecular Biology. 2023. https://doi.org/10.1002/bmb.21783."
204,930,4,200,sucess-download,"Huang, R.; Hirschbiegel, C. M.; Lehot, V.; Liu, L.; Cicek, Y. A.; Rotello, V. M. Modular Fabrication of Bioorthogonal Nanozymes for Biomedical Applications. Advanced materials (Deerfield Beach, Fla.). 2023. https://doi.org/10.1002/adma.202300943."
204,925,4,200,sucess-download,"Xu, Z.; Gamble, A.; Niu, W. A.; Smith, M. N.; Siegrist, M. S.; Tuominen, M.; Santore, M. M. Contact Area and Deformation of  Langmuir : the ACS journal of surfaces and colloids. 2023. https://doi.org/10.1021/acs.langmuir.3c00089."
204,1175,4,200,sucess-download,"Xie, M.; Gao, M.; Yun, Y.; Malmsten, M.; Rotello, V. M.; Zboril, R.; Akhavan, O.; Kraskouski, A.; Amalraj, J.; Cai, X.; Lu, J.; Zheng, H.; Li, R. Antibacterial Nanomaterials: Mechanisms, Impacts on Antimicrobial Resistance and Design Principles. Angewandte Chemie (International ed. in English). 2023. https://doi.org/10.1002/anie.202217345."
204,121,4,200,sucess-download,"Liu, Y.; Han, J.; Wang, Y.; Li, A.; Zhao, J.; Su, Y.; Shen, L.; Xing, B. Suspected sources of microplastics and nanoplastics: Contamination from experimental reagents and solvents. Water research. 2023. https://doi.org/10.1016/j.watres.2023.120925."
204,573,4,200,sucess-download,"Seong, H. G.; Fink, Z.; Chen, Z.; Emrick, T.; Russell, T. P. Bottlebrush Polymers at Liquid Interfaces: Assembly Dynamics, Mechanical Properties, and All-Liquid Printed Constructs. ACS nano. 2023. https://doi.org/10.1021/acsnano.3c02684."
204,1216,4,200,sucess-download,"Wang, Y.; Xiang, L.; Wang, F.; Redmile-Gordon, M.; Bian, Y.; Wang, Z.; Gu, C.; Jiang, X.; Schäffer, A.; Xing, B. Transcriptomic and metabolomic changes in lettuce triggered by microplastics-stress. Environmental pollution (Barking, Essex : 1987). 2023. https://doi.org/10.1016/j.envpol.2023.121081."
204,832,4,200,sucess-download,"Kim, J. W.; Chen, C.; Kim, H.; Kim, S. H.; Hayward, R. C. Effect of surface tension on elastocapillary wrinkling of interfacially adsorbed hydrogel disks with photothermally programmed swelling profiles. Soft matter. 2023. https://doi.org/10.1039/d3sm00001j."
204,1391,4,200,shorty-download,"Cui, S.; McClements, D. J.; Shi, J.; Xu, X.; Ning, F.; Liu, C.; Zhou, L.; Sun, Q.; Dai, L. Fabrication and characterization of low-fat Pickering emulsion gels stabilized by zein/phytic acid complex nanoparticles. Food chemistry. 2022. https://doi.org/10.1016/j.foodchem.2022.134179."
203,1314,3,200,sucess-download,"Donovan, S. M.; Abrams, S. A.; Azad, M. B.; Belfort, M. B.; Bode, L.; Carlson, S. E.; Dallas, D. C.; Hettinga, K.; Järvinen, K.; Kim, J. H.; Lebrilla, C. B.; McGuire, M. K.; Sela, D. A.; Neu, J. Summary of the Joint National Institutes of Health and the Food and Drug Administration Workshop Titled ""Exploring the Science Surrounding the Safe Use of Bioactive Ingredients in Infant Formula: Considerations for an Assessment Framework"". The Journal of pediatrics. 2022. https://doi.org/10.1016/j.jpeds.2022.11.027."
203,1357,3,200,sucess-download,"Tarafdar, L.; Mohapatra, M.; Muduli, P. R.; Kumar, A.; Mishra, D. R.; Rastogi, G. Co-occurrence patterns and environmental factors associated with rapid onset of Microcystis aeruginosa bloom in a tropical coastal lagoon. Journal of environmental management. 2022. https://doi.org/10.1016/j.jenvman.2022.116580."
203,1394,3,200,sucess-download,"Danylchuk, A. J.; Griffin, L. P.; Ahrens, R.; Allen, M. S.; Boucek, R. E.; Brownscombe, J. W.; Casselberry, G. A.; Danylchuk, S. C.; Filous, A.; Goldberg, T. L.; Perez, A. U.; Rehage, J. S.; Santos, R. O.; Shenker, J.; Wilson, J. K.; Adams, A. J.; Cooke, S. J. Cascading effects of climate change on recreational marine flats fishes and fisheries. Environmental biology of fishes. 2022. https://doi.org/10.1007/s10641-022-01333-6."
203,687,3,200,sucess-download,"Xu, D.; Gu, T.; Lovley, D. R. Microbially mediated metal corrosion. Nature reviews. Microbiology. 2023. https://doi.org/10.1038/s41579-023-00920-3."
203,790,3,200,sucess-download,"Kundu, A. N.; Dougan, C. E.; Mahmoud, S.; Kilic, A.; Panagiotou, A.; Richbourg, N. R.; Irakoze, N.; Peyton, S. R. Tenascin-C Activation of Lung Fibroblasts in a 3D Synthetic Lung Extracellular Matrix Mimic. Advanced materials (Deerfield Beach, Fla.). 2023. https://doi.org/10.1002/adma.202301493."
203,359,3,200,sucess-download,"Valdez, E.; Chan, J.; Dixon, S.; Carroll, G. D.; Phuntsog, T.; Delorme, E.; Egan, J.; Gubrium, A. Participatory Action Research to Explore the Role of Structural Violence on Marginalized and Racialized Young Parents. Health education & behavior : the official publication of the Society for Public Health Education. 2023. https://doi.org/10.1177/10901981231197397."
203,988,3,200,sucess-download,"He, X.; Hu, W.; Li, W.; Hu, R. Digital transformation, technological innovation, and operational resilience of port firms in case of supply chain disruption. Marine pollution bulletin. 2023. https://doi.org/10.1016/j.marpolbul.2023.114811."
203,827,3,200,sucess-download,"Cho, M.; Harlin, E.; Ihm, J.; Lee, C. H. Event history analysis on racial disparities in the path to adoption for Black and White children. Child abuse & neglect. 2023. https://doi.org/10.1016/j.chiabu.2023.106231."
203,648,3,200,shorty-download,"Tax, G.; Guay, K. P.; Soldà, T.; Hitchman, C. J.; Hill, J. C.; Vasiljević, S.; Lia, A.; Modenutti, C. P.; Straatman, K. R.; Santino, A.; Molinari, M.; Zitzmann, N.; Hebert, D. N.; Roversi, P.; Trerotola, M. Rescue of secretion of a rare-disease associated mis-folded mutant glycoprotein in  bioRxiv : the preprint server for biology. 2023. https://doi.org/10.1101/2023.05.30.542711."
202,271,2,200,sucess-download,"Raman, V.; Howell, L. M.; Bloom, S. M.; Hall, C. L.; Wetherby, V. E.; Minter, L. M.; Kulkarni, A. A.; Forbes, N. S. Intracellular  Frontiers in immunology. 2023. https://doi.org/10.3389/fimmu.2023.1228532."
202,192,2,200,sucess-download,"VanDonselaar, K. R.; Bellido-Aguilar, D. A.; Safaripour, M.; Kim, H.; Watkins, J. J.; Crosby, A. J.; Webster, D. C.; Croll, A. B. Silicone elastomers and the Persson-Brener adhesion model. The Journal of chemical physics. 2023. https://doi.org/10.1063/5.0172415."
202,651,2,200,sucess-download,"Hadidi, M.; Hossienpour, Y.; Nooshkam, M.; Mahfouzi, M.; Gharagozlou, M.; Aliakbari, F. S.; Aghababaei, F.; McClement, D. J. Green leaf proteins: a sustainable source of edible plant-based proteins. Critical reviews in food science and nutrition. 2023. https://doi.org/10.1080/10408398.2023.2229436."
202,996,2,200,sucess-download,"Calabrese, E. J.; Pressman, P.; Hayes, A. W.; Dhawan, G.; Kapoor, R.; Agathokleous, E.; Calabrese, V. Lithium and hormesis: Enhancement of adaptive responses and biological performance via hormetic mechanisms. Journal of trace elements in medicine and biology : organ of the Society for Minerals and Trace Elements (GMS). 2023. https://doi.org/10.1016/j.jtemb.2023.127156."
202,559,2,200,sucess-download,"Gupta, A.; Ndugire, W.; Hirschbiegel, C. M.; Grigely, L.; Rotello, V. M. Interfacing Nanomaterials with Biology through Ligand Engineering. Accounts of chemical research. 2023. https://doi.org/10.1021/acs.accounts.3c00255."
202,107,2,200,sucess-download,"Kalelkar, A.; Sipe, G.; Castro E Costa, A. R.; Lorenzo, I. M.; Nguyen, M.; Linares-Garcia, I.; Vazey, E.; Huda, R. A paradigm for ethanol consumption in head-fixed mice during prefrontal cortical two-photon calcium imaging. Neuropharmacology. 2023. https://doi.org/10.1016/j.neuropharm.2023.109800."
202,906,2,200,sucess-download,"Leonard, E. R.; Marques, E. S.; Roy, M. A.; Conlin, S. M.; Ranjan, R.; Timme-Laragy, A. R. Dietary exposure to the food preservative tert-Butylhydroquinone (tBHQ) impairs zebrafish (Danio rerio) survival, growth, organ development, and gene expression in Nrf2a-dependent and independent ways. Food and chemical toxicology : an international journal published for the British Industrial Biological Research Association. 2023. https://doi.org/10.1016/j.fct.2023.113788."
202,1062,2,200,sucess-download,"Luo, X.; Wang, Z.; Wang, C.; Yue, L.; Tao, M.; Elmer, W. H.; White, J. C.; Cao, X.; Xing, B. Nanomaterial Size and Surface Modification Mediate Disease Resistance Activation in Cucumber ( ACS nano. 2023. https://doi.org/10.1021/acsnano.2c11790."
